1111111111111
1000000000C01
1000000000001
10C0111111001
1P001E0000001
1111111111111
