11111111111111
100N0000000001
1C000C0000CN01
100000N0000001
10000000000001
10C0111111CN01
1P0C1E00000001
11111111111111
