1111111111111
1C000C0000C01
1000000000001
10C0111111C01
1P0C1E0000001
1111111111111
